Sergipe (SE) - SBAR	 (Aracaju)
Pará (PA) - SBBE  (Belém)
Minas Gerais (MG) - SBBH	(Belo Horizonte)
Roraima (RR) -  SBBV	(Boa Vista)
Distrito Federal (DF) - SBBR (Brasília)
Mato Grosso do Sul (MS) - SBCG (Campo Grande)
Mato Grosso (MT) - SBCY	Marechal Rondon (Cuiabá)
Paraná (PR) - SBCT	Londrina (Curitiba)
Santa Catarina (SC) - SBFL	 (Florianópolis)
Ceará (CE) - SBFZ	Pinto Martins (Fortaleza)
Goiás (GO) - SBGO	Santa Genoveva (Goiânia)
Paraíba (PB) - SBJP	Pres. Castro Pinto (João Pessoa)
Amapá (AP) - SBMQ	Internacional (Macapá)
Alagoas (AL) - SBMO	Zumbi dos Palmares (Maceió)
Amazonas (AM) - SBMN	Eduardo Gomes (MANAUS)
Rio Grande do Norte (RN) - SBNT Dix-Sept Rosado (Natal)
Tocantins (TO) - SBPJ	Palmas (Palmas)
Rio Grande do Sul (RS) - SBPA	Salgado Filho (Porto Alegre)
Rondônia (RO) - SBPV	Gov. Jorge Teixeira de Oliveira (Porto Velho)
Pernambuco (PE) - SBRF	Guararapes (Recife)
Acre (AC) - SBRB	Internacional (Rio Branco)
Rio de Janeiro (RJ) - SBGL	Santos Dumont (Rio de Janeiro)
Bahia (BA) -  SBSV	Dep. Luís Eduardo Magalhães (Salvador)
Maranhão (MA) - SBSL	Mar. Cunha Machado (São Luís)
São Paulo (SP) - SBSP	Guarulhos (São Paulo)
Piauí (PI) - SBTE	Sen. Petrônio Portella (Teresina)
Espírito Santo (ES) - SBVT	Eurico Aguiar Salles (Vitória)

https://prnt.sc/rkpt7k